########
#.   @ #
#    $ #
#$##   #
# ##$ .#
#    ###
#   .###
########
